333333333333333333333333333333
300020444200402000020000200003
302040203040402030402040204003
303040203020402040302040302003
320232420403020203040403020203
302030402030402030402030402003
330204030204030204030204030203
300020000200002000020000200003
302040203040402030402040234003
303040203020402040302040302003
320232420403020203040403020203
302030402030402030402030402003
330204030204030204030204030203
333333333333333333333333333303
